					
					
					
F 225,225,250 
NO ./xpm/N.xpm
S ./xpm/S.xpm
C 10,111,200
W ./xpm/W.xpm
    
    EA ./xpm/E.xpm
       






        

   111111111111111111111111
  1111111000000010000001111111 
    11111111100000000000001100111 
      11111111000W00000000000111111
       1110000000000000111111111 
       110000001100000011
		1111111111111111111111


